111111111111
111111111111
-2222222222-
--11111111--
---111111---