22-111111-22
22-111111-22
33-222222-33
--11111111--
----2222----
---11--11---
--11----11--