XXXXXXXXXXXX
X33X33X33X33X
X33X33X33X33X
X--X--X--X--X
XXXXXXXXXXXX
---X-33-X---
--X--22--X--
-X---11---X-
X----XX----X
XXXXXXXXXXXX