X-11-XX-11-X
X-22-XX-22-X
X-33-XX-33-X
X-22----22-X
X-11----11-X
------------
--XXXXXXXX--
---X3333X---
----X22X----
-----XX-----